subject_id	consent_code	study_nickname	reported_sex
subject1	HMB-IRB	ARIC	Other
subject2	GRU	ARIC	Female
subject3	GRU	JHS	Unknown
subject4	GRU	JHS	Female
subject5	DS-CVD	JHS	Other
subject6	GRU	ARIC	Female
subject7	DS-CVD	JHS	Other
subject8	DS-CVD	ARIC	Other
subject9	DS-CVD	JHS	Unknown
subject10	GRU	JHS	Unknown
subject11	DS-CVD	JHS	Male
subject12	GRU	UKBB	Unknown
subject13	GRU	ARIC	Other
subject14	DS-CVD	JHS	Other
subject15	HMB-IRB	JHS	Other
subject16	HMB-IRB	ARIC	Male
subject17	DS-CVD	JHS	Female
subject18	HMB-IRB	JHS	Female
subject19	DS-CVD	JHS	Other
subject20	DS-CVD	UKBB	Unknown
